# Syntax Colouring Map For COZIR

# Data types (KEYWORD1)
COZIR	KEYWORD1
C0ZIRParser	KEYWORD1


# Methods and Functions (KEYWORD2)
init	KEYWORD2

setOperatingMode	KEYWORD2
getOperatingMode	KEYWORD2

celsius	KEYWORD2
fahrenheit	KEYWORD2
humidity	KEYWORD2
light	KEYWORD2
CO2	KEYWORD2
getPPMFactor	KEYWORD2

fineTuneZeroPoint	KEYWORD2
calibrateFreshAir	KEYWORD2
calibrateNitrogen	KEYWORD2
calibrateKnownGas	KEYWORD2

setDigiFilter	KEYWORD2
getDigiFilter	KEYWORD2

setOutputFields	KEYWORD2
getOutputFields	KEYWORD2
inOutputFields	KEYWORD2
clrOutputFields	KEYWORD2
getRecentFields	KEYWORD2

setAutoCalibrationPreload	KEYWORD2
getAutoCalibrationPreload	KEYWORD2

setAutoCalibrationInterval	KEYWORD2
getAutoCalibrationInterval	KEYWORD2

setAutoCalibrationOn	KEYWORD2
setAutoCalibrationOff	KEYWORD2
getAutoCalibration	KEYWORD2

setAutoCalibrationBackgroundConcentration	KEYWORD2
getAutoCalibrationBackgroundConcentration	KEYWORD2

setAmbientConcentration	KEYWORD2
getAmbientConcentration	KEYWORD2

setBufferClearTime	KEYWORD2
getBufferClearTime	KEYWORD2

getVersionSerial	KEYWORD2
getConfiguration	KEYWORD2


# Constants (LITERAL1)
COZIR_LIB_VERSION	LITERAL1


# OUTPUT FIELDS

CZR_LIGHT	LITERAL1
CZR_HUMIDITY	LITERAL1
CZR_FILTLED	LITERAL1
CZR_RAWLED	LITERAL1
CZR_MAXLED	LITERAL1
CZR_ZEROPOINT	LITERAL1
CZR_RAWTEMP	LITERAL1
CZR_FILTTEMP	LITERAL1
CZR_FILTLEDSIGNAL	LITERAL1
CZR_RAWLEDSIGNAL	LITERAL1
CZR_SENSTEMP	LITERAL1
CZR_FILTCO2	LITERAL1
CZR_RAWCO2	LITERAL1
CZR_NONE	LITERAL1
CZR_DEFAULT	LITERAL1
CZR_HTC	LITERAL1
CZR_ALL	LITERAL1


# OPERATING MODE

CZR_COMMAND	LITERAL1
CZR_STREAMING	LITERAL1
CZR_POLLING	LITERAL1


# EEPROM REGISTERS

AHHI	LITERAL1
ANLO	LITERAL1
ANSOURCE	LITERAL1
ACINITHI	LITERAL1
ACINITLO	LITERAL1
ACHI	LITERAL1
ACLO	LITERAL1
ACONOFF	LITERAL1
ACPPMHI	LITERAL1
ACPPMLO	LITERAL1
AMBHI	LITERAL1
AMBLO	LITERAL1
BCHI	LITERAL1
BCLO	LITERAL1
